********
*@**@***
* ** ***
*@   ***
**    @*
**** ***
      @*
********
