********
*@** ***
* ** ***
*@   *@*
****   *
**@* ***
**    @*
** *****
